:  
аккуратный: красивый 
английский: испанский 
апельсиновый: томатный 
арбузный: дынный 
безобразный: неудобный 
богатый: самобытный 
быстрый: аккуратный бесшумный 
вареный: жареный печеный 
вежливый: гостеприимный приветливый улыбчивый услужливый 
веселый: колоритный непринужденный 
вкусный: ароматный доступный европейский разнообразный сытный тематический ценный 
внимательный: вежливый 
грязный: бедный драный серый 
деревянный: металлический 
добродушный: улыбчивый 
доброжелательный: дружелюбный отзывчивый улыбчивый 
добрый: вежливый старательный улыбчивый 
достойный: доброжелательный 
драный: ржавый 
дружелюбный: вежливый компетентный ненавязчивый 
жареный: калорийный тушеный 
желтый: зеленый 
замечательный: внимательный классный 
зеленной: красивый 
индийский: континентальный 
интересный: необычный 
итальянский: кубинский японский 
качественный: недорогой 
классный: приветливый 
колоритный: контрастный 
комфортный: удобный 
короткий: интересный 
красивый: белоснежный зеленый интересный светлый чистенький чистый 
крепкий: здоровый 
лиственный: хвойный 
малолюдный: спокойный 
мандариновый: гранатовый 
мелкий: плоский приятный теплый чистый 
мрачный: жуткий 
мутный: беспокойный грязный 
напряжной?: интересный 
небольшой: неплохой 
невкусный: заветренный 
немецкий: местный 
нормальный: песчаный 
обильный: разнообразный 
огромный: зеленый светлый чистый 
острый: огромный соленый 
отзывчивый: добрый 
отличный: приветливый 
песочный: дрожжевой 
песчаный: чистый 
плотный: вкусный сытный 
приветливый: позитивный 
приличный: просторный стильный чистый 
приятный: внимательный ненавязчивый отзывчивый уютный 
прозрачный: теплый 
просторный: чистый 
разнообразный: вкусный 
русскоязычный: англоязычный 
свежий: сосновый 
семейный: активный 
серый: некрасивый скучный 
сильный: прохладный 
современный: свежий 
соленый: кислый острый 
спокойный: тихий 
старый: грязный 
стильный: комфортный красивый 
сувенирный: фруктовый 
теплый: нежный 
тихий: спокойный 
тонкий: вкусный 
тоооооненький?: тооооолстенький? 
удобный: комфортный 
удобрый?: приятный 
узкий: грязный шумный 
уютный: чистенький чистый 
хороший: вкусный гостеприимный красивый песочный приветливый разнообразный светлый среднестатистический сытный уютный чистый 
чистый: аккуратный красивый приятный прозрачный светлый теплый уютный хороший 
шоколадный: клубничный 
энергичный: внимательный 
